0101011100111010010010111001111001101110100101010101010100010000010100110111111110101101001001000110
0010111101001011101010001101100000011100101010101101001001011010000101100111011111001000111111110010
1001000001110011111101111101010000101110000101000001001001111001110000001111000100010001101110000100
1110011011011111000001010101101010101101110111110100000001110010110100110100101011101101011010000101
0111001011100010101110000011001011101110101110011110110000111101100110010000000111010011001100001011
0000010101110111101000000111010010111001110010111000101111000111111110111010010010001010110100000010
0111111110100011110111100111000110100000101110011100100001101011010111111001010000010110010100100100
1000011100110110011001001110100111110111001010101010111001011111110001000001001000001100110010001101
1111010010011010000010011101010010000010111001010101101110100101111000110111110110110000010001010010
0100110111001000000010000000101100111011100001010010111101110001100001000100011011001001000111000000
1110000001010001010010110001010110101011001001110000110010110110101010000100011110100011000100001110
0000111111011101110011011101100101000111100010110110110000011100010101000110100100100000011101000001
0001101101111010011011010001000100010110101110110100001101001101111110100100100011011100010011111111
1001011001001011110101111011001110101011010000000110010001100001100101000001111001100000111110010110
1000011111000011101010001111001110111000100110000000001101000010001101000000100010101101011110101001
1111110100000011110000100100110110010000000001101001010000111101110000100001101001110110100001100010
0100111111001011000100011001000000111001011100110110101001111100101100011110111101000110110110011011
1011011110110011100111110010010001011001100111001110000001101110010010100011010110000100010011101001
0001101011000111010010010011000000101110100011000001010011110000111110000011001101011111000100100111
1010010100111111110101101100110111101100000110111101000111111001010100100011110010010111111011101111
0010010010000010001111001101111010110000011011110011111111101001001001000010000000100111100010010001
1001101011010110010111110101110011010110001110110001010001101011111110010010000110110110110110011100
1100011011001000000011011110001001110111010000001000011010110111101010001100000010110111011110010101
1001010101111111111110000000111000001111100111000110100110001000001001100000111111000101111000111010
1000100000001001100110010000101101001111010011001110001101000010010010100011111000101000101001110011
1101110000100110011011000101111101000100000111111000101101001101011010110111101000100010101001100100
0101011111000110001001011100101011110111100010011011000000001101010001110011001110010111110101010001
0011110101100110101101100000101100110010110101000011000110100000000110111011011111010111010100001001
1110001001000101101100101000000010010000000000011100011100001001110100111000110101011101101111100111
0011000101010101111101110000111010111001011011011011011100100011110101010110111000000110011111110010
1100011010011011101011001100000010011001111111111110010101110111011001101100110101011100001111100010
1011111001011111001100100001010001100011110111011100111110110101100110111111011110000011100000100010
0101110011001011001111001001100111101111111001000011001100000010100110101100011111001100110110111101
1100111001110111100011111001110001111101011011101110101011011000000110011110100001001100000000110010
1110100000000111101011110001011011111011110111010100000100110001001101000011111101100101111010100010
0100111100010111000101000111110001001101010011101001010010010101100101000001011111110100110010100000
1011011111111110001000111101111101001101101100110011000111000001101110110101101010111111110111010011
1100000010100110100011011000110110001110000010011011000110111000000110111100111001001011010010100001
1111010010001001110001100100000111100010000001111011001010011000011010001000001100000010101100011111
0111110111000101101011010001100000001111010011000010011000100100000110111101001111100001100111101011
1001001110111000000100110010010101111010011110010000101011101000111100111110001010100000010011001111
0000101101111101010111100110110011001011110111100100100100011011100001111010111111101000100011001111
1111001001110100101101011101100011101101000010110100001000011110111010011101011100010111010000001001
0101111111010111111101001000100101001100000001100110110001000110100110111011001010111011001000001010
0110101111101001000101011111111001100110000000001101111111100110110000110001110010001111011001110101
1001111100110001000110110100001110110100010111111001111111101010000100100011000001100110101010111011
0100000010010111110010011000101101110110111011101101111000010110101111110010011000111011011110001000
1000110100000010000110111100101011000011111101000110100111101101001110011110011000100000100110001001
0011000011011111001101001000011100001010110010000001111011011010100001001001101110110011001000101100
0001000111001110110111011110001110101001110011000110001110000010111100111111111001000101000101111011
1110110011100000010011100110011110010010110000101111001011010101101110101000010010111101001011100101
1110010101110011000010100000001011101100011001001001100000110010100111001010011101101010111101011110
1011011101010110001011001011001110111110100010111111001101101111100010101010001110101011100000111101
0101011110001010111100111011001001110011101010110001101010011010111001100100111000110110010111111001
1011111110001001101011010101111010111110110111000101100110100100000010110111001011110101001011111110
1100111000100010111100000111011011111001100011111110101000101010111000000110001011010000010110000101
0100010000111100100100011001010101000001010111011001000101111100101110100100001011000001000110010000
1110000011111011101100100100011110101011111110111101100101011000000001001110001101111010111011101000
0011101110001000010011111001000001001110101010001010101111111101101001001000101011011000100001001011
1111000111101111100010100101100001001000010110011000101101010111010010110110100001101111000101100011
1001001000010000110001001011000000111001111000010011011110000011001010100000110001001101111010101111
1000010010111100101010100101000101101110001101100000010111110111111110100100110001001001000110101100
0111110101101110100011000000001100110000100001111000100110100010001111000110000101001001100100110101
1011011110010100000000110101001100011000011111101101101101111011001000110111011010110100110101100111
0010010010000111000000000111001010110101111011001100110110101100011001100011011010011001001111000110
1001011010001001011100011111110110010101001000001010110110100001001111111110000101110100000110111111
0110110100100001011110000111100010101110111111010111000000000100000001110101011111011011110011000100
0101111101010101000000010011001001100011100111100110101000001110011011111100000000010000111010101101
1010100110000100100001110100011100100001001011100111111000010000011001111111110100101001001111000011
1111000001101111110100110010010111111000011100010011000110000100001001110111111100011101001010101010
1000100100011101001001011011111001011000010000011100011111100111000110000010111000101001101000110100
1111110010100011000011111011000110101100010010010011001010101111011110111110101110011101011100111001
1000001010100111101001100110000010000000011010100101001000111011000000010100110110111111100101111100
0001001110100101100110000111011110010111100011111101001001100101100000110000011110000001011110110000
1011101100100010111111110110111000011100100110110100010001100001011011011011000001000011000110010011
1100011110010101011111000101111010000000011000101001011011101100001100010110011111100100010101111000
1100010111011010011000100111000110001101000011001110011110010000110001001111110001000100000011100001
0001101011101000010001111101000101111011001101111111011111110000110110000010001010100100011000000110
0010000010101011101100101111010111011101110000010100000111000101010101100100001001100100001010000001
1001000011010111001001001110000101100111111110000010000110111110101101110010010101001101101011011101
1101101110111101110100111000110001001011101110111101100000001010101101101011001000000111111110101101
0111001101100001101001001010000000000001101110010011101100001100100111010101110110001011011100000001
1000000010100010001010110011100110001010111011111001000010100000110111000111000101110001001101010000
1111111001010110011011001011011000001000101110011000000000010101110110001101110000111011001011110011
1000111110111110111011111111011001100110101001000101000001100110000101101010000101001101101110011011
1001101001001101111010011000101010011001010111000101100010100111000101110000000011101010101001101001
1111111011100011010100000111100110101110010101010011110100010010110001010010011110001110101010001101
1010100110100101000000110011110011101001011000000110011011101010000100010111010000110010010101011111
0100011110000110011110011110010010011110100000100100100010110110011110011010000001001011000111111001
1001011110011001000110101000100000011011101100000100000111011111110001001111001010101011001010100111
0001100001110000110101110101010101111010110101101100111100001010000010010100101110001001001010010011
0100100100010010010111001010010000111000101000100011101010000111100100110001011011100001111010011111
0110111101100010010001111010011111110010111001000101010001101000100001101111000100110010010111010001
1110001010111101110110111100001010011100011101011011001111110010001011010000111111011001111100011100
0110111110011110101010100001011001001011110001000001001101110110001011111000100111011100100110010000
1000100001011101111011110111001101100011001000110001010100010111100110000110010100110011001010101011
0100001001000111010101100101101010001101010110000000111101101000010011001010111000010010000001110000
1100111010100001101000001000111101101011001111101110010000110011101011100000011010111110000111001110
1001010010101000010101011101010010010111111001100010110110100110101011111100000010011000001101011111
0001011001101001010110100001110010010000101001001111000000001100001001100011111110111111110101101010
